WWWWWWWWWWWWWWWWWWWWWWWWWWW
W D  PP     P    MWWWW J KW
W W M   WWWDWWWDWW      W W
W WWWDDWWWWDWPWPWWWWW     W
W   K     W DPW   M   P   W
WWWWWWW WWW WPW W PPPPPPPPW
WK D        WPW      D   KW
W WWWWW WWWWWWWWW W WWWWW W
W M   D     P     D     WMW
WPK W  PWWWWWWWWWP   W    W
WWWWWWWWWWWWWWWWWWWWWWWWWWW