WWWWWWWWWWWWWWWWWWWWWWWWWWW
W            P    MWWWW   W
W W     WWWDWWWDWW      W W
W WWW  WWWWPWPWPWWWWW     W
W  J      W   K   M   P   W
WWWWWWW WWW M   W DDDDDDDDW
W M K D     WPW   D  K PP W
W W  WW WWWWWWWWW W WWWWW W
W     D    M  K   D D  K  W
W   W   WWWWWWWWWPDP  P   W
WWWWWWWWWWWWWWWWWWWWWWWWWWW