WWWWWWWWWWWWWWWWWWWWWWWWWWW
WJ  PPPP     P    MWWWW  KW
W W M   WWWDWWWDWW      W W
W WWWDDWWWWPWPWPWWWWW PPP W
W   K     W DPW   M   P   W
WWWWWWW WWW WPW W PPPPPPPPW
WK    D     WPW   D      KW
W WWWWW WWWWWWWWW W WWWWW W
W M   D PPPPPPPPP D     WMW
WPK W  PWWWWWWWWWP   W    W
WWWWWWWWWWWWWWWWWWWWWWWWWWW